....................
....................
....................
......USUSUSNS......
.....NSNSNSNSNS.....
.....SNNSNNSNNS.....
.....U.N.N..UNN.....
..... .N.U.N.U......
.....NNNNNNNNNN.....
.....NNSNSNSSSN.....
...................
....................
....................


