.....UUUUNSNUUUU.....
......UNNSSSNNU......
.......UNNSNNU.......
........UNNNU........
.........UNU.........
........UNNNU........
.......UNNSNNU.......
......UNNSSSNNU......
.....UUUUUNUUUUU.....
.....................
