....................
....................
.....USNNNSSUUN.....
.....SNUNSNNSUS.....
.....S.U.N..SNN.....
.....UNSNSNSSUS.....
.....NNNSUS.NSN.....
.......SSUUN........