....................
....................
....................
....................
.....NNSNNSNSNS.....
.....NNNNSNNSNS.....
.....U.U..UNSNS....
.....U.U.N.S.SN.....
....................