....................
....................
.....SUUSSSUUUU.....
......SS.S.S.SS.....
.....NNSNNSNSNS.....
.....NNNNSNNSNS.....
.....U.U..UNSNS....
.....U.U.N.S.SN.....
.....NNNSNNNSSS.....
......SS..SSSS......
....................
....................
....................
....................
