....................
....................
.....UUUSSSUUUU.....
......SSS...SS......
.....NNSNNSSNNS.....
.....NNNNSNNNNS.....
.....U..UUU..SU.....
.....U.SNNS.SU......
.....NNNSSSNNNS.....
......S.SSS.SS......
....................
....................
....................
