.....................
.......................
.....UNNNNNNNNNU......
.....UNNSSSSSNNU......
.....UNNSSSSSNNU......
.....UNNSSSSSNNU......
.....UNNSSSSSNNU......
.....UNNNNNNNNNU......
.....UNNNNNNNNNU......
.....UNNNNNNNNNU......
.....UUUUUNUUUUU......


