.....................
.....UUUUUNUUUUU......
.....UNNNNNNNNNU......
.....UNNSSSSSNNU......
.....UNNSSSSSNNU......
.....UNNSSSSSNNU......
.....UNNSSSSSNNU......
.....UNNNNNNNNNU......
.....UUUUUNUUUUU......
.....................
.....................

