    ....................
    ....................
    ....................
    ......USUSUSUS......
    .....NSNSNSNSNS.....
    .....SNNSNNSNNS.....
    .....U.U.U..UUU.....
    ..... .U.U.U.U......
    .....NNNNNNNNNN.....
    ....................
    ....................
    ....................
    ....................


