....................
....................
......UNSSSSNU.....
......USSSSSSU......
.....UNNNNNNNUU.....
.....NN......NN......
.....NN.SSSS.NN.....
.....UN.S..S.NN.....
.....UUNNNNNNNU.....
......UUNNNNUU......
....................
....................
....................
