....................
....................
.....NSNSNSNSNS.....
.....NNN.NNN..N.....
.....NNSNNSNSNS.....
.....SSSSSSSSSS.....
.....NNN..NNNNN....
.....NNN.N.N.NN.....
....................
....................