....................
....................
.....NNNNNNNNNN.....
.....NNNNNNNNNN.....
.....NNNNNNNNNN.....
.....SSSSSSSSSS.....
.....NNNNNNNNNN....
.....NNNNNNNNNN.....
.....NNNNNNNNNN.....
....................