.....................
.........U.U.........
........UNNNU........
......UUNNSNNUU......
.....UNNNSSSNNNU.....
.....UNNSSSSSNNU.....
.....USSSSSSSSSU.....
.....UNNSSSSSNNU.....
.....UNNNSSSNNNU.....
......UNNNSNNNU......
.......UUU.UUU.......
..................
.....................