.....................
.....................
.....UUUUNNNUUUU.....
......UNNSNSNNU......
.......UNNSNNU.......
........UNNNU........
.........UNU.........
....................
.....................
.....................
