....................
....................
.....SSUUUUSS......
......S.SS.S.S......
.....NNSNNSNNSN.....
.....NSNNNSNNNS.....
.....U...UNS..U.....
.....U.N.U.S.U......
.....NNNSSNNNSS.....
......SS..SSSS......
....................
....................
....................
