.....................
.........U.U.........
........UNNNU........
.......UNNSNNU.......
......UNNSSSNNU......
.....UNNSSSSSNNU.....
.....USSSSSSSSSU.....
.....UNNSSSSSNNU.....
......UNNSSSNNU......
.......UNNSNNU.......
........UU.UU........
..................
.....................