.....................
.....................
..........U...........
.........UNU..........
........UNNNU.........
.......UNNSNNU........
......UNNSNSNNU.......
.....UUUUUNUUUUU.......