....................
....................
.....UUUUUUUUU.....
......USSSSSSU......
.....UNNNNNNNUU.....
.....UN.....NU......
.....UN.SSSS.NU.....
.....UN.S..S.NU.....
.....UUNNNNNNNU.....
......UUUNNUUU......
....................
....................
....................
