.....................
.........U.U.........
........UNNNU........
.......UNNSNNU.......
.....UNNNSSSNNNU.....
.....UNNSSSSSNNU.....
.....USSSSSSSSSU.....
.....UNNSSSSSNNU.....
.....UNNNSSSNNNU.....
......UNNNSNNNU......
........UU.UU........
..................
.....................